Any movie that has vampires I like !	任何有吸血鬼的电影我都爱！
Familt Guy , The Simpons , Futurama , and South Park ! ! ! !	“恶搞之家”，“辛普森一家”，“飞出个未来”，“南方公园”！！！！
funny but I 've heard it before	有趣但我已经听过
I have joined the new organization Rap Is Cr*P !	我已经加入的这个新组织Rap很糟糕！
But yes , this show is addicting !	但是是的，这个展览很让人上瘾！
So , I do n't believe in true friends anymore .	因此，我不再相信真朋友。
ok thats supposed to be with muffins , but it 's stupid either way . 	好那应该有松饼的，但怎么样这都很蠢。
And check out wikipedias site about SS .	然后看看关于SS的维基百科网站。
But always try to do your best .	但是一直尝试尽力。
Behind The Green Door , that 's the best porno movie I ever saw .	绿门之后，那是我看过最棒的色情影片。
no i do n't think so but they r both fine	不我不这样想但他们都很好
'Your mom ' is not an answer ! )	“你妈妈”不是种回答！）
the animal house soundtrack is always a winner !	动物屋的配音一直都最棒！
Yes , if he says on his website he will sue , he probably means it .	是，如果他在网站上说他会起诉，他应该就会。
tank top or halter top and jeans , perhaps ?	一个坎肩或者一个吊带和牛仔裤？
... and it 's prolly cuz they could n't spell Lincoln .	...可能因为他们不会拼林肯这个词。
if u listened closly , i 'd al ready said it.good luck !	如果你认真听，我已经讲过了。祝你好运！
And you would want to meet the devil not unless your life sucks .	而且你不会想见到恶魔除非你生活实在烂透了。
i 've got a crush on him , like , forever !	我已经爱上他，永远！
Actually , the title is Na Na Hey Hey Kiss Him Goodbye	实际上，题目是呐呐嘿嘿和他吻别
Finally , one of them asked , What did she roll ?	最后，他们中的一个问道，她卷什么了？
its gon na be off the hook	它将摆脱困境。
Especially after the way she treated his mother ! !	特别是在她那样对他妈之后！！
-102 & the story goes on : D	102并且故事继续
say hi like nothing ever happened between you .	像你们之间什么都没发生那样打招呼
i wish it would rain-temptations ?	我希望会下雨-诱惑乐团
they both fricken suck cuz ive never seen them	他们都烂透了因为我从没见过他们
anything from evanescence to mozart but no country	任何从evanescence变到mozart但是没有国别的东西
scary movie 1,2,3 , euro trip final destination	惊声尖笑1，2，3，欧洲任我行死神来了
check out this link ... lots of places & prices !	看看这个链接……许多地点和价格！
HE IS TO ME FOR NOW , OUR BLACK GEORGE CLOONEY .	他~现~在~对~我~来~说，是~我~们~的~黑~人~版~乔~治~克~鲁~尼。
What do think will he sue ?	你觉得他会起诉吗？
sheet music plus is not free .	额外的活页乐谱不免费。
Apolo Anton Ohno ( Olympic speed skater USA )	阿波罗·安东·天哪（美国队的奥林匹克速滑运动员）
blame it on the rain kiss the rain	怪雨吧亲吻雨
I ca n't choose , so I would say - both .	我没法选，所以我会说-都行。
evidently this was a sunday school song	这明显是个主日学校的歌
Anyway , I think country songs are basically diaries or something .	无论如何，我认为乡村音乐基本上就是类似于日记的东西。
there must be a guardian angel that protected the baby	肯定会有守护天使保护小宝宝
I Love the Black Eyed Peas ! ! !	我爱黑眼豆豆！！！
anything you can play with your hands : banjo , mandolin , tambourine , congas , maracas , the triangle ... etc .	任何你用手能演奏的乐器：班卓琴，曼陀林，长号，康茄鼓，沙球，三角铁……等等
because hes not on the 20th story	因为他不是在写20世纪的故事
oh and the fight scenes and choreography ROCKS ! ! !	噢而且打斗场面和舞蹈编排好~极~了！！！
they are lazy and have nothing important to do	他们懒而且没啥事儿做
hmmmmmmm ok.k there in the room with there clothes off .	嗯~好，好吧他们脱掉衣服在房间里。
the offspring because all their songs sound good .	因为后裔乐队所有的歌都很好听
Beat It - because there is Eddie Van Halen on the guitar !	打败它——因为Eddie Van Halen是吉他手！
But me , I just like to bake .	但我，我就是喜欢烘焙。
If anyone has a copy , I 'll totally buy it .	如果任何人有复制品，我肯定会买。
WOW ... ... .THATS A REAL GOOD ONE , HMMMMMM , IMAGINATION CAN BE A GOOD THING..IMAGINE THAT HUH..LOL..PEACE OUT..	哇... ...那~个~真·~不·~错·，嗯·~,想象力是个好东西……想象一下~~~那个~~~呃……哈~哈……再~见……
dont get me wrong i like jennifer , shes cute but angie is hot .	别误会我喜欢詹妮弗，她可爱但是安吉很性感。
it is closed series.so do n't expect it	这个电视剧完结了。别期待了。
it would have to be superman .	肯定是超人。
you could tell them your engaged ? ! ? ! ? !	你会告诉他们你订婚了？！？！？！
That thing you do - by WONDERS TOO GOOD SONG , NICE MOVIE TOO	你做的那事-奇~迹~乐~团~的~一~首~好~歌，也~是~一~个~好~电~影
i really don`t know i love both sooooooo ... . much	我实在不知道我两个都特特特特特特特……别喜欢。
she is still married to josh and billy likes her too .	她仍是乔希的妻子而且比利也喜欢她。
my man smells so darn good ! !	我男人闻起来太棒了！！
But I do n't see that show anymore .	但我不再看那个展览了。
some do , others stand out front and smack camera crews	有些人会这样，其他人挺身而出殴打摄制组
I love Pearl Jam , but I have to go with Metallica ...	我爱Pearl Jam，但我只能选择Metallica...
ca n't choose they 're both very good	没法选他们都很好
What the hell kind of school do you go to ? !	你去的是什么狗屁学校？
Ooh , I ca n't eat another bite ( munch munch , explode )	噢，我吃不下了（嚼嚼，快吐了）
I 've got TiVo ready to go .	我已经让TiVo准备好了。
but then it was just pulled off the air ? ! ? ! ? ! ?	但是后来它就真空了？！？！？！？
Biographys im obsessed with Johnny Cash since I saw Walk The Line	我看完一往无前后，对Jonny Cash的传记很着迷
the music changed so much i dont think they have any good songs that they play in a club	音乐变了太多我不觉得他们在酒吧放什么好歌
the new one has johnny depp	新的里面有Johnny Depp
I believe it is a mid 90 's movie maybe '95 or '96	我确信它是九十世纪中期大概95年或96年的电影
anyone else get what im saying ?	有人知道我在说啥吗？
can you include your e-mail please ? ?	能请你把你的邮箱包括进去吗？？
that song breaking free or whatever its really amazing	那首叫我心乘风还是啥的歌很不错
Unless you can pin down a single bass he favors ...	除非你能固定住他喜欢的那个低音乐器...
the Munsters did n't have a butler ... the Addams family had Lurch .	怪怪家族里没有男管家...但是亚当斯一家里有挫折。
yes they do i never really thought about that thats weird thanx for pointing that out	是的他们是我从没考虑过那个真的很奇怪谢谢你指出来
If Superman were n't Superman , and he was just Ok man , would it be the same ?	如果超人不是超人，只是好男人，一切还会一样吗？
SAME THING DIFFRENT DAY SHE 'S STILL A CRACKHEAD AND HER HUSBAND IS STILL BEATING THE CRAP OUT OF HER	一样的事情~不同的时期~~~她还是个瘾君子~而她老公依旧把她打个半死~~~
bucky should , but probably somebody good will	巴奇应该这样，但是可能有好人会做的
jen is a good girl and angelina is the bad boy	jen是个好女孩而安吉丽娜坏坏的
what 's her name in real life ?	她真名叫什么？
She looks down into her pajama bottoms and SCREAMS !	她向她睡衣里看然后尖~叫！
There celebrity nickname would have to be Foxxhack .	这里名人昵称会是Foxxhack。
) ... or a David Bowie and Trent Reznor song .	）...或者大卫·鲍伊或者特伦特·雷兹诺的歌。
And you call yourself a prof ?	你叫你自己教授？
Who the hell are the rest ?	谁他妈是剩下的？
Those are the ones that I can think of right now . 	这些我现在想不起来。
it shows you people with lot of money and fame leads to unhappy life .	看起来你们这些有钱有名的人生活不开心。
U can type but ca n't talk ... ... ... .ummmm , u must be growing invertly ! ! !	你会打字但不会说话...嗯嗯嗯嗯，你肯定长歪了！！！
if your into christan punk then you know thousand foot krutch .	如果你喜欢christian punk那你就会知道 thousand foot krutch。
I want to be on Wheel of Fortune ! !	我想上命运之轮这个节目。
Hes a very down to earth person ... and very cool !	他非常接地气...而且非常酷！
limewire , bearshare , imesh and the best BITTORENT	limewire , bearshare , imesh还有最棒的BITTORENT
too many good ones to pick	太多好的了没法选
i think brad is having some sort of crises .	我觉得brad正在经历某种危机。
Back when they actually played music .	回到他们真正演奏音乐的时候。
Its not really even that scary , just disturbing .	它没那么可怕，就是烦人。
Yup , even had a small part in one once.. fun stuff .	对，曾经还有过其中的一小部分……很有意思。
: Dhaha LOOK I JUST WIPED A BUGER AT YOU HAHA	：Dhaha看~我~刚~在~你~身~上~擦~了~鼻~屎~哈~哈~
they made her even more ugly for the role	他们让她为了角色变得更丑
I just like her better than Angelina .	我就是喜欢她超过安吉丽娜。
gerard 's not gay , dude..but if he vas ville vallo would definitely be his boyfriend..or billie joe from green day !	兄弟...gerard不是同性恋，但他如果是那他男友一定是ville vallo……或者绿日乐队的billie joe！
I liked the movies too and there is a Shrek 3 coming up soon !	我也喜欢电影而且怪物史莱克3快上映了！
A : She opens the car door	A：她打开车门
it was so funny b/c a lot of it was so right !	它有趣是因为它是对的！
Now I feel much better , thanks .	谢谢，我现在好多了。
you put her in a cylindricalroom and tell her to sit in the corner .	你让她待在圆柱形房间里还叫她坐在角落。
mmmm , that is a tough one .	嗯嗯嗯嗯，这很艰难。
Chicken Little and its about darn time ! ! ! ! ! ! ! ! ! ! ! ! !	现在该看四眼田鸡啦! ! ! ! ! ! ! ! ! ! ! ! !
It just ended last year ( I think ) with the movie Star Wars : Episode III : Revenge of the Sith .星球大战系列去年完结了（我觉得）最后一部电影叫星战前传Ⅲ：西斯的复仇。
i agree i think they are gross too .	我同意我也觉得他们很恶心。
Answer : Do n't try to butter me up !	回答：别试图奉承我！
my god i wish i did !	天哪我希望我做了！
and people still talk about him and his work like the man is not dead ! ! !	人们仍谈论他和他的工作好像这个人还没死！！！
I think sarcasm is extremely funny !	我认为反讽超级有趣！
i loved that show and then one saturday i turned it on and it was n't playing .	我爱那个电视剧然后某个周六我打开它但它没播。
I dont even know the show ... as in what time it is aired and so on ...	我甚至不知道这个展览……比如它什么时候上映的等等...
We have HUGE malls out here .	我们外面有超~大~的商场。
I met the guy who played Bear Bryant in Forrest Gump	我碰到在阿甘正传里扮演Bear Bryant的那个人
Lol , did I make you laugh ?	哈哈，我逗你笑了吗？
Tim Allen in The Shaggy Dog	长毛狗中的提姆 艾伦
So go to the beach or lake and go splash around ... you never know , it just might be fun .	所以去海滩或者湖边到处走走...你不知道，有可能会有意思。
Tanks , again , Missus , he replies , brushing them off .	再一次，谢谢，老婆，他回答道，别理他们。
isnt it sad that entertainers arent like this anymore .	艺人们不再喜欢这个了难道不悲伤吗。
Nicole kidman was great.I liked reese whitherspoon too .	尼克基德曼很棒。我也喜欢reese whitherspoon。
what is there to lie about ?	有啥好撒谎的？
One to do whatever you want it to do .	做你想做的任何事。
tell me the web pliz ... i try a lot website but still did n't got it..	请告诉我网站吧……我试了好多网站还是不明白……
Naruto cuz its exciting and awesome and the best out of those three	火影忍者因为它让人激动又非常棒是这三个中最好的
There are a LOT of songs that do that to me !	有很~多·~歌·给我这样的感觉！
You 're missing someone ... YOU are ; ) Love you to bits ! !	你在想念某人……你~在 ~想; )超喜欢你！！
i dont kno if this is funny or sad or both but told me here it goes ... ... ...	我不知道这是有趣还是伤感还是都有告诉我我要说了.........
Hey , you know the Beck song Deadweight ?	嘿，你知道the Beck的歌Deadweight吗？
: D but this is all just me , you know : D	: D但这全都只是我一个人，你懂的: D
i don ; t know but he had great music .	我不知道但他有好音乐。
one dance move thats is really a hip hop move would be called crunking	一个舞蹈动作那真的是嘻哈动作被叫做转动
i play guitar and some piano ... ..yet i cant read a note of music ... .lol	我弹吉他和钢琴……但我不认识音符……哈哈
it is a girl but she is extremly fugly .	她是个能拆但她丑爆了。
This is a strange Q & A , but I still do n't know what u R talking about .	这个问答很奇怪，但我仍然不知道你在说啥。
then find ur song.. try it ! !	然后找到你的歌...试试！！
this is wat it sounds like when the love strikes .	这就是爱情到来的声音。
First of all , it 's Rap not Rape .	首先，这是说唱不是强奸。
you have to watch it to appreciate it .	你必须看它欣赏它。
i like both , but i 'm going to say simpsons	我都喜欢，但我会说辛普森一家
but thats just my opinion , and thanks for your answer on my qiestion .	但那只是我的观点，谢谢你的回答。
But where one can do this another ca n't do that .	可这就是有人能做的来这个其他人做不了的地方了。
stay in the bathroom the whole day	待在浴室一整天
If so what was the movie ? 	如果这样那什么才是电影？
I agree with fluor Check it out pal !	我赞成是萤石 检查一下兄弟！
I ca n't believe everyone is talking crap about this question ?	我不敢相信每个人都在对这个问题胡说？
because the boy was so ugly that she could n't look at him anymore .	因为男孩太丑所以她不再看他。
Way too young for me but such a sweetheart .	对我来说太年轻了但是是个情人的好人选。
The thing is I do n't really know how to play .	问题是我不知道怎么演奏。
i would want to be Vegeta.. but hes not exactly a super hero .	我想当贝吉塔..但他并不算个超级英雄。
Well , after all , his name IS Peter !	好吧，毕竟，他的名字是~皮~特！
Its a real riot watching it .	看着它就真是混乱。
i like her movies and want to know what you think	我喜欢她的电影而且想知道你怎么看
personally , i feel its a cool way for de-stressing and relaxing ... . !	个人来说，我认为这是个很酷的减压休闲方式... .！
hoop hoop but i am a Capricorn dude	呼呼 呼呼 但我是个摩羯座的人
I liked Apocolypse Now ( the original ) Martin Sheen did an awsome job ! ! !	我现在喜欢Apocolypse（原版）马丁·西恩干得好！！！
I do n't know , but they turn purple when you kick them in the smurf sack !	我不知道，但你在精灵袋里打他们时他们会变成紫色！
There were things that overwhelmed me , he says .	他说，我被一些东西所震撼。
DO YOU KNO HIM IN REAL LIFE ?	你~现~实~生~活~中~认~识~他~吗？
I JUST FINISHED IT AND IT IS GREAT !	我~刚~完~成·~它~而~且~它~很~棒！
the only song i like of hers is super old but its skater boi	我唯一喜欢她的一首歌超级老叫滑雪者boi
His song is cool ... .he is cute one day , and then the next he 's not ... .wierd hugh ? ?	他的歌很酷 ... .他一天可爱，然后一天不可爱 ... .奇怪吧哈？？
To which the little brother replied , No , but Gramma is !	小弟弟回复道，不，但是奶奶回复了！
because it was just so bad or offensive ?	因为它太差或者太冒犯人？
That 's right , Emo was once not something kids called themselves .	对的，Emo曾经不是孩子们自称的称呼。
I 'm gon na go with amy 's song ... but what do you think ?	我要听艾米的歌...但你怎么看？
It was good enough for me to ask others what they think , so ... What 'd you think of it ?	征求他人意见对我来说够好了，所以...你怎么想？
Basically , just a Hey ... how are you ... I am David ( introduce urself with your name ) ..helps tremendously .	基本上，只是一个嘿...你怎么样...我是大卫（介绍你自己的名字）……就会有很大帮助。
2 ) I 'd force her to eat a cheeseburger .	我强迫她吃芝士汉堡。
Queen of the Damned sucked big time though .	吸血鬼女王真烂虽然兴盛一时。
did you hear about the new pirate movie ?	你听说过新海盗电影吗？
NIRVANA is the greatest ever ... HELL F*CKIN ' YEAH !	涅~槃~乐~队是最棒的……真~他~妈~的~对·！
well , he came from outerspace so he still would be unusual .	好吧，他从外太空来所以他仍是不正常的。
simba off the lion king , he 's evil you know ... ... ... ... ... ... ...辛巴不是狮王，你要知道他是坏的...............
Reggie Miller , Clyde Drexler , Charles Barkley , Michael Jordan ... ... ... ...	雷吉·米勒，克莱德·德雷克斯勒 ，查尔斯·巴克利 ，麦克·乔丹............
it was gross adnd ugly ... .stupid pro life people pro choice all the way ! !	它又恶心又丑...愚蠢的人生人们一直在选择！！
Well , no she said , I 'm actually a blonde .	好吧，不她说，我实际上是金发。
they have n't done me any bad !	他们没对我做过坏事！
has no accent but also is alot more techno . 	没有口音但是更加电子乐。
they probably did and they just want to fake out the paparazzi	他们可能做了而且他们只是想捉弄狗仔
Sounds like the Bee Gees song , Staying Alive .	听起来像比吉斯乐队的歌，活着。
With out a Trace.. the steven movie being talked about Came later than the 80 's	...史蒂芬备受关注的电影在80年代后才上映。
Chicks only like him for his money ! !	女人们爱的是他的钱！！
opera ghost it was on phantom of the opera	歌剧魅影它是关于歌剧的幽灵
i do n't know but the song is hella tight ! ! ! !	我不知道这首歌是hella tight！！！！
eminem because his some of his music is just so funny and relevent to todays pop music enviorment .	阿姆因为他的一些音乐很有趣而且与当今的流行音乐环境有关。
Mine was Audio Adrenaline ever heard of them , or should I ask , are they still around ?	我的是Audio Adrenaline乐队从没听过他们，或者我应该问，他们还在吗？
she 's the wife of john lennon .	她是约翰列侬的妻子。
i didn'r think it was good .	我不觉得它很好
select a source which is having 3 to 4 stars**** .	选择有3到4颗星的资源****。
the mexican lady dr did the surgery and the cute young dr who slept with grey helped her .	墨西哥女医生做了手术并且和格雷睡了的可爱年轻医生帮助了她。
if you mean dylan from 90210 and cohen from oc then totally cohen .	如果你说的是90210的dylan和oc的cohen那么肯定是Cohen。
Yeah we can tell , just look at your cartoon avator ! !	是的我们能看出来，只要看看你的卡通人物！！
i would be suprised if i had no eyebrows	如果我没眉毛我会很惊讶
we work all the times and dont see eachother that much .	我们一直工作不怎么经常见对方。
Do n't have nothing else to do !	没别的事儿干
I 'm sure hes in the phone book < : ) <	我确定他在电话簿里< : ) <
THE ONLY ONE I KNOW OF IS HOOPZ ... ... ..WHICH IS mydarlingnikki.com 	我~唯一~~知道的网站是~HOOPZ ... ... ..就是~~mydarlingnikki.com
See if what I say is n't true .	看看我说的是否不对。
yes but have stop eating out at resturants 	是的但是你必须停止出去去餐馆吃饭了。
No it wouldnt be the same , cause his name wouldve changed	不这不一样，因为他的名字可能早就改了
It 's more of an off white .	这颜色实际是灰白色。
I dont know i dont really watch that show that much	我不知道我真的没有看多少那个节目
usher ! chris brown copies usher and 50 cent does n't even dance	亚瑟！克里斯·布朗抄袭亚瑟，况且五毛甚至不会跳舞
Well atleast the voters got wise and booted KEVIN COVAIS out	至少还不错，投票者们变聪明了还赶走了~~凯文·柯威斯~~
she 'd get torn apart by simon .	她被西蒙搞得快分裂了。
keira knightly & keanu reeves were looking great .	凯拉·奈特莉&基努·里维斯都长得不错。
Yes because that is the only thing im good at , when it comes to lying.LOL	是的，说到说谎，这是我唯一擅长的事了。哈哈哈
I saw him in person once .	我曾经亲眼看到过他。
its the fact that i 'm never going to get that time back !	事实就是我没法让那时光倒流！
When I was younger I use to ice skate and lots of biking loved both	我小一点的时候经常去滑冰还有经常去骑行我喜欢这两项运动
gets them all excited and loud , but in a good , happy way	让他们变得兴奋和高亢，不过是以一种良好的快乐的方式
Yes and so does Baa Baa Black Sheep	是的就是黑绵羊咩咩叫
I think he was definitely cheating on her !	我觉得他绝对欺骗了她！
i only finished it because i hate not seeing how a movie ends .	因为我讨厌看电影时不看它如何结尾所以我把它看完了。
Sugar We 're Going Down by Fall Out Boy	翻闹小子的一首歌糖我们要下去了翻闹小子的一首歌
Ashley Simpson , I f**in hate her !	希礼·辛普森，我实在太讨厌她了！
NO , he 's not gay Why are you so obsessed with other peoples lives ?	不，他不是一个同性恋为什么你要执着于别人的生活？
go to their websites , and apply there .	上他们网站，在那里申请。
its like you can move with it and just go with the flow .	就像你可以跟着它动，随流动而动。
She was easily the hottest one on the show this year !	很明显她是今年这场演出中最火辣的那个！
Just looking at her face annoys me to no end !	看这个她的脸让我的怒火没法消！
but i do n't think it 'll happen .	但是我认为它不会发生。
Yup , got ta be the Cat in the Hat .	是的，一定是戴帽子的猫。
I think it 's time to stop !	我觉得是时候停止了！
who knows there are rumors flying everywhere	谁都知道谣言满天飞
i like the song vampire heart .	我喜欢吸血鬼之心这首歌。
Way too much rap is boneheaded garbage !	太多的说唱都是愚昧的垃圾。
i could go on and on ! ... .and asking for TWO hoops nonetheless ... .LOL ... . : D	我还能继续！... .再来两个环 ... .哈哈... . : D 
or they both have the letters m and e in them which spells me !	或者他们都有字母m和e拼读在一起就是me了！
I did n't see anything for free .	我没看到任何免费的东西。
Do n't be fooled by da rocks dat she got !	不要被她那些石头神马的给欺骗了！
Want to hear another dirty joke ?	想听另外一个黄段子吗？
sex is when a man and woman get together and get verry intiment .	性是女人和男人交合变得亲密无间
other then that i 'm a golden girl ... .hahahaha.	除了我是一个黄金女郎... .哈哈哈哈
i like a lot of different kinds rock .	我喜欢许多不同风格的摇滚乐。
that 's a crappy question to ask	这真是一个蹩脚的问题
he has quite a few on stage too ...	他在舞台上有很多 ...
why did they stop playin that movie on the disney channel anyway ?	为什么他们无论如何都要在迪士尼频道停播那部电影？		
Lovely movie ... Johnny Depp was in it ... that says it all ...	非常好的电影 ... 约翰尼·德普在这部电影中... 这就很好... 
i enjoy all if someone plys it ..	我享受一切，如果有人玩的话 ..
I cant wain to see the reuinon , what about yall ?	我迫不及待的想看到再次统一，你们呢？
Definately a flick worth your time .	完全是一部值的你花时间的电影
( everyone seems to have forgotten that you are an addict .	( 大家似乎都已经忘了你是个瘾君子。
We have n't made it yet , Jen ... ; )	我们没成功, 珍 ... ; )
-- Warriors of Virtue ( probably the worst movie ever made ... so horrible it was hilarious tho )	--五行战士( 可能是最糟糕的一部电影  ... 非常讨厌，滑稽至极)
I think my friend just died !	我觉得我朋友刚死了！
I love Days of our lives ! !	我喜欢我们的日子 ! !
I agree Jason x sucked but the first Terminator was just as bad ..	我同意星际公敌很糟糕但是第一部终结者同样糟糕..
if that movie was a person i think it 'd have to kill it .	如果那部电影是个人我觉得我会杀了他。
you could be a founder of a student based anime club !	你可以成为以学生为主体的动漫俱乐部的创始人！
u want to count that from US ? ?	你想要从我们开始数数么？？
1st part is ok but parts 2 & 3 r hopeless	第一部分还行但是第二部分和第三部分没啥希望
Thanks much for your help if u can .	如果您能帮到的话非常感谢。
the song is nice and i like it .	这首歌很好我很喜欢。
Warning : It 's a lot more boring than you 'd hope .	警告：它比你预想中的无聊多了。
made it and I like most of his animated movies .	成功了而且我喜欢他的大多数动漫电影
He sounds like an old version of Rod Stewart on crack cocaine ! ! !	他听起来就像个吸了可卡因的老版洛·史都华。
I am not a girl , but iI think it comes naturally	我不是个女孩，但是我相信变成女孩是自然而然的
I still find it funny though .	但是我仍然发现这个很有趣
The man came out with tears in his eyes , I tried , but I ca n't kill my wife .	这个人眼里含着泪走了出来，我试过了，但是我还是不能杀掉我妻子。
A B C D E F G those r the notes .	A,B,C,D,E,F,G那些是音符。
Milli Vanilli - Blame it on the Rain ?	米力·瓦利 - 归咎于雨？
STEVE PERRY , GEORGE JONES , AND LORETTA LYNN	史蒂夫.佩里~~乔治·琼斯~~~和洛雷塔·林恩~~~
are kasey kahne and kristy labonte still dating ?	Kasey Kahne和Kristy LaBonte还在约会吗？
right along with the rest of the characters .	就放在其他角色的旁边。
- You really expect him to come back ?	-你真得希望他回来吗？
ur mommas so stupid , she tried to put M & M 's in alphabetical order !	你的妈妈如此愚钝，竟然试着按字母顺序排列M和Ms。
I think he is pretty awesome , too ! !	我认为他也是非常的优秀！
Both r good but really liked the original Star Wars movies	两个都很好但是我更喜欢那部原创电影星球大战。
If she said dat she was from da block den she was ..	如果她说她来自附近街区那她就是了..
It would break my heart if I found out him and Bob were a couple ! ! !	如果我发现她和罗伯特是情侣，我会崩溃的！！！
amazon.com for like 15 bucks plus shipping and handling	亚马逊上15美元还要加上运费和装卸费。
you could look back one day and see younger students following your footsteps ... and feel nostalgia in the process ... hehe ...	总有天你回顾过往，看到年轻的学生们追随着你的步伐，你会很怀恋... 呵呵 ...
men are obsessed because , u rarely see girls like that	男人们都很着迷因为，你很少能见到像那样的女孩。
if not check it out its a jam !	如果不是就试试吧那是个jam！	（不确定）
texas chainsaw ~ the remake..was viscous ugly..and The Exorcist..still freeks me	德州电锯杀人狂的重拍版..实在是倒胃口..驱魔..还是吓到我了
WHAT DO YOU CALL A BRUNETTE IN BETWEEN TWO BLONDES ?	你叫那个站在两个金发人中间棕发人什么？？？
But , I think hoopz looked way better than her .	我觉得hoopz比她更好。
Depends how old and what kind of movie .	取决于电影有多老还有它的类型。
You if you spanish you should get some spanish cds	如果你说西班牙语你应该得到一些西班牙语的唱片
so yeah theres my rant : ) I cant wait till july ! !	是的这就是我念叨的 : ) 我不想等到七月！！
I watched some guy Masterbate on a webcam ... ... ..	我看有个家伙在网络摄像头下手淫
Cheers if you could tell me !	你能告诉我就好了！
rap & hip hop is the S*** ! !	唱和嘻哈音乐好极了！！		不确定
kinda a Anti Hero , but a villain also .	有点像反派英雄，但也是个恶棍。
she says k then i 'll give you 15 cookies .	她说可以那我就给你15个饼干。
That 's the way God made it , next question please ?	这就是上帝造它之法，下个问题请问？
ang is taking brad on a wild ride .. 	昂正带着布拉德进行一场疯狂之旅。
i love them all ... well expect rappers ... rap is lame	我爱它们所有 ... 除了说唱的，说唱真的很差劲。
FIGHT CLUB , buy it , rent it , watch it , then read the book	搏击俱乐部~~买它，租它，看它，然后再读这本小说
I go to the WB website and summerland is n't on it anymore 	我去WB网站看了，海岸情缘不再在上面了
Sometimes I lay out and night and get moon-burn ... ouch	有时候晚上我躺在外面就被月亮灼伤了... 哎哟		不确定
the name of the road is north !	这条路的名字叫北方！
I was crazy once , they locked me up in a room full of worms .	我曾经发疯过，他们把我关在一间满是虫子的房间里。
NO , but she has a great A*S and thats good enough for me .	不，然而她的后背非常迷人这点对我来说足矣。
And the man says , That 's weird , I work for 'Four Seasons Hotel '	这个男的说，那太奇怪了，我在‘四季酒店’工作
or you think you 're much smarter than travolta ?	还是说你觉得你比特拉沃尔塔更聪明？
johnny depp ... always has been , always will be ... he 's a classic	约翰尼.德普...个经典人物，现在是，将来也是...
There was o boy n a girl who were in a relationship.then they had a huge fight .	有个男孩和一个女孩是恋人，然后他们大吵了一架。
have some one give u head	找人让你享受一下
Oh , and do n't trust anything at supershadow.com .	噢，不要相信supershadow.com这个网站上的任何信息。
Two blondes walk into a bar ... ... ... you think one of em wouldve seen it !	两个金发碧眼的女人走进了一家酒吧... ... ... 你觉得她们其中的一个已经看到它了！（不确定）
there is a guy with no arms and no legs laying on the beach .	一个没胳膊没腿的男人正躺在海滩上。
their music has gotten me through some bad times .	他们的音乐帮我度过了那些艰难的时光。
i have songs downloaded on my computer of his .	我电脑上下载的歌曲中有他的歌。
at the moment it is your man by josh turner .	此刻的歌曲是你的男人，来自乔什.特纳。
both if i were really really really really Lucky !	但愿我真的真的真的真的很幸~~运~~！
fave band : destiny 's child fave singer : beyonce fave actress : beyonce	最喜欢的乐队：真命天女 最喜欢的歌手：碧昂丝 最喜欢的女演员：碧昂丝
unless you 're playing like a 5,000 seat outdoor festival anytime soon .	除非你不久打算举办一场可以容纳500人的户外音乐节。
that refers to 'shakin the bootie '	那指的是'抖起屁股'
But if Bruce Banner gets ambushed , Juggernaut wins .	但是如果布鲁斯.班纳被偷袭了，红坦克就赢了。
I had to drink after watching that one ! !	看完那个之后我必须喝酒！！
Hi , I seriously need help deciding which manga I should spend my money on ...	嗨，我真的需要你帮我决定我应该花钱买哪本漫画......
Give me some names to try & test it .	给我一些名字去测试一下。
It 's right up there with Gone with the Wind , The Green Mile , and Shawshank Redemption ... all classics .	就像乱世佳人，绿色奇迹以及肖申克救赎......都是经典。
what i have heard , i do n't like , cuz its annoying 	我听到的话，我不喜欢，因为它太让人恼火了
if you slip ... i will catch u in my curls ...	要是你滑倒了......我会用我的卷发接住你......	不确定
he makes up all his stuff himself .	他独自整理了所有的材料。
LOOK AT UR FACE IN THE MIRROR ************LOL****	照~~镜~~子~~看~~看~~你~~的~~脸~~ ************哈哈哈****
they get married but that does n't mean she ca n't stay with her father also	他们结婚了，但这也不是意味着她不能和她爸爸一起住了。	（不确定）
Killing a worthless celeb like paris hilton for example is not worth going to jail for .	杀一个毫无价值的名人比如帕丽斯.希尔顿而被关进监狱不值得。
Look out world , these guys could be massive !	放眼世界，这些人终将大获成功！
It takes a lot of money to look this cheap !	为了让它看起来很廉价可花了不少钱！
its funny how all the other people who answerd this Q are girls	好有趣啊其他所有回答了这个问题的人都是女孩。
Something like , Did Jesus ever have sex ?	比如，耶稣有过性生活吗？
it is the only colour that it can be ,	这是它唯一的颜色，	不确定
is that what r kelly meant to happen ?	那就是罗伯特.凯利说的要发生的事情吗？
not tooo too old I 'm only 21	还没有很~~很~~大啦我只有21岁
are you serious or really just that stupid ?	你是认真的还是真的蠢？
Thats a pretty good one thanks	那个真的很好谢谢
i think you just fried my brain	我觉得你让我很烧脑
sarcasm is my fav so arent hemmoroids see see i cant help myself	我最爱挖苦别人但这不是海莫罗兹症 看 看 我控制不住我自己	（不确定）
Val Kilmer in Tombstone I got 2 guns 1 for each of ya .	瓦尔.基尔默在电影墓碑镇里说：“我有两把枪，一把给你们。”
he says my mama says not to and i dont want to	他说我妈妈不让做的事情我不想去做
( The one where Rory moves in to her Yale dorm )	(罗里搬到她耶鲁宿舍的那个)	（不确定）
Pros Vs. Joes or maybe Who Wants to be a Millionaire	普罗斯对阵乔斯或者谁想成为百万富翁
he would not need to deny it .	他不需要否定它。
Oh yea she sings pretty good too .	欧耶她也唱得非常好。
Johnny says Grampa , your dog is growling at me !	约翰尼说爷爷，你的狗在对我叫！
well ... i think Alicia Keys is rockin the RnB scene	嗯...... 我觉得艾丽西亚.凯斯会震惊R&B乐坛。
I do n't do vell vit the ladies 	我不善于和女人们交流。.
Ahhh ... ..Rupert Grint plays Ron Weasly in the Harry Potter movies	啊......鲁伯特.格林特在哈利.波特系列电影中扮演罗恩.韦斯莱。
better to listen to decent stuff than what is out there today .	与其听些今天的东西倒不如听些好点的。	不确定
as i said theres soo many good ones out there !	正如我说的那样外面有很多好东西！
the super strength and x-ray vision doesnt hurt either ...	超级力量和透视眼中的哪一个都没有坏处...
They start agruing back and forth deer tracks ! , Wolf Tracks ! , Deer Tracks ! , Wolf Tracks ! .	他们开始反复争论 鹿的痕迹！，狼的痕迹~~！，鹿的痕迹~~！狼的痕迹~~！
muffincakes got it ... . it did't specify window of what floor of d bldg ...	松饼蛋糕 我知道了......它没有指明窗户在这栋楼的几楼......
no i dont like gettin in front of a lot of people	不，我不喜欢站在很多人面前。
my milkshake.. is better than yours , better than yours.. p.s .	我的奶昔......比你的好，比你的好......比如.	(不确定）
fav band spoken fav singer I do n't have one fav actress kate hudson	最喜欢的乐队是spoken 最喜欢的歌手我没有 最喜欢的女演员是凯特.哈德森
OF COURSE NOT BUT IT DOES SELL	当~~然~~不~~但~~它~~确~~实~~在~~销~~售
I like real club music not that loud , overplayed crap they blast in club these days !	我喜欢真正的俱乐部音乐，不是这些天他们在俱乐部放的那种吵闹，夸张的蹩脚音乐。
Yeah , it was a guy , that 's why it was so weird .	是了，它是公的，所以他看着这么奇怪。	（不确定）
Why does everyone here have really bad music tastes ?	为什么这里每一个人都有这么差的音乐品味？
ever but if you mean rap then that would be Bow Wow .	但是如果你指的是说唱，那么就是Bow Wow。
i love patch adams ... .can watch it all the time ... like pretty woman , the matrix among others	我喜欢心灵点滴......可以一直看它......就像是看风月俏佳人，黑客帝国
Play with the fire , And you 're gon na to get burned .	玩火，你会被烧伤的。
I am totally with you on this one !	在这点上我完全同意你！
how do you get a blond to kill herself ?	你是如何让那个金发女人自杀的？
i do n't know why i 'm so crazy about it .	我不知道为什么我对它如此着迷。
2 of the greatest Irish rock bands HORSLIPS and MAMAS BOYS You Heathens ! ! !	HORSLIPS 和 MAMAS BOYS You Heathens 是爱尔兰乐队中最好的两个！！！
legally blond is what i call geeky !	律政俏佳人就是我觉得很讨人厌的那种！
do n't knw but i guess thts y they made money green n now smoke'em both	我不知道，但是我猜那就是他们两个为什么通过环保赚钱现在却都吸烟	（不确定）
They just loooove having a lot of clothes !	他们只是喜欢~~买很多衣服！
they r one of the best bands in the world & VILLE VALO is SEXY !	他们是世界上最好的乐队之一，维勒.瓦洛~~很~性~感~~！
i like the name Cohen ... so COHEN will be the KING	我喜欢这个名字 科恩......所以科恩~~会成为国王~~
( BTW , the actor who died was Bela Lugosi , star of Dracula ! )	（顺便提一下，这个演员去世了，他叫贝拉.卢戈西，演过德古拉！）
Uncle Rico : I coulda told you that .	里科叔叔：我本要告诉你那件事的。
and the horse starts galloping he starts going faster !	当这匹马开始飞奔的时候他开始跑得更快了！
there 's an ice cream shop just down the street if you like the machanic tell him .	顺着这条街有家冰淇淋店，要是你喜欢这个技工就告诉他。
I have to say , Led Zep ... ..from the first time I heard them I was just floored ... ..	我必须说，齐柏林飞艇......从第一次我听到他们，我就被迷住了。	（不确定）
i 'll have to say they might be giants .	我得说他们很可能会成为巨星。	（不确定）
Hence , I do not want 10 points .	因此，我不想得10分。
i am just sick of hearing about them .	我听腻了他们的事。
go yo yahoo.com/movie downloads maybe you will find one	去雅..雅虎网站/电影下载，或许你能找得到。
Cuzz she is the hottest actress out there .	库兹她是那里最红的女演员。
The charcters are fun to love , hate , pick on , drool over .	喜欢，讨厌，批评，或痴迷于这些人物角色都是很有趣的。
Favorite actress : Jamie Foxx and anglea bassett	最喜欢的女演员：杰米.福克斯和安吉拉.贝塞特
I CA N'T WAIT , I 'M COUNTING DOWN THE DAYS .	我~~等~~不~~及~~了，我~~一~~直~~在~~倒~~数~~着~~日~~子~~。
is 2758574 , but add india 's code number in he front	电话号码是2758574，但是要在前面加印度的区号
I love Hurt , The Perfect Drug ... .oh , and so many more songs !	我喜欢赫特，完美的毒药.....嗯，还有很多歌曲！
give me a sec , this may take awhile	给我点时间，这可能会需要一会。
thats a great Question ! but sorry i dont know ! maybe trying to write new songs 4 lp .	那是一个很好的~~问题~~！ 但对不起 我不知道！ 或许在尝试为LP写些新歌。（不确定）
THEY 'VE LINKED HIM TO SO MANY PEOPLE .	他们~已经~把他~和很多人~~联系~~在一起了~~
are you plannin on buying your girlfriend tampons ? ? ?	你打算给你女朋友买卫生巾吗？？？
first part and second until the battle then it sucked soooooooo much its unbelievable	第一和第二部分直到战争开始后它太太太太太太太太恐怖了，让人难以置信。
i 'll eat anything you want me to eat .	你想让我吃什么我就吃什么
A girl I know insisted that I watch it with her .	我认识的一个女孩坚持让我和她一起看。
Sound ca n't travel in a vacuum , so 0 f/s ...	声音不能在真空中传播，所以速度是0 f/s......
it might be available illegally now , but they usually sell a c.d .	现在卖碟片可能是违法的，但是他们通常卖的是cd。
Hugh ... he just knows what he 's doing !	休......他知道自己在做什么！
a baby seal walks into a CLUB !	一只小海豹走进一家俱~~乐~~部！
regarding rape i hope they dont .	说到强暴我希望他们没做。
pointsreaper is lame he can not sue Yahoo for him cheating , what a cry baby	pointsreaper站不住脚他不能因为自己作弊就去起诉雅虎，太爱抱怨了（不确定）
it would be cool because hes strong , quick , funny and hes got like 600 diffrent types of arrows !	那一定很酷因为他强壮，敏捷，有趣而且他有600支不同类型的箭！
Because stupid guys keep on giving them money	因为愚蠢的家伙们一直给他们钱
I SAY SABBATH , LETS SEE WHAT YOU THINK .	我说~安息日~~，让我们~~知道~~你怎么想的~~~！！！
and Gosh , you 're such an idiot .	天哪，你真是一个傻瓜。
His make up and outfit was so awesome in the movie	这部电影里他的妆容和服装实在太好了
The OC thing was totally off track !	那个OC完全跑偏了！
Like when you get pulled over for speeding ?	比如你因为车速过快被截停过？
It 's no question actually , just say something anything specially stupid thing	实际上没问题，只是说了些愚蠢的事
well , it gives a nice feeling to choose and buy things .	当然，挑选东西和买东西让人感到愉悦。
She 's also looks fun and flirty .	她也看着很有趣也很轻浮
and he points to his leg .	然后他指向他的腿。
I think I was all hyped up for brokeback so I did n't find it that great .	我觉得我是因为对断背山期待过高了所以觉得它并不是那么好。
How do you drown a blonde ? ? ? ?	你是如何让一个金发女郎对你着迷的？？？？
I thought it was a great movie it was AWSUME BABY ! ! !	我觉得这是部好电影好~~极~~了~~宝贝！！！
A : Yeah , I sure did n't see that one coming .	A :是的，我确实没料到那件事会发生。
Meatloaf can sing his ass off .	密特·劳弗能唱很长一段时间。
Black Eyed Peas My Hump or Pump It or anything by this group !	黑眼豆豆合唱团的我的波波或者加油或者其他任何歌曲！
I still watch it every morning on TBS !	我仍然每天早上在TBS电视台看这个！
what are a couple of good bit rates and converters	什么是好点的比特率和转换器	
But he sure does make me laugh !	但是他真的可以逗我笑！
i think cause her husband had left	我觉得是因为她丈夫死了。
I do n't love her but I do n't hate her either .	我不爱她，但是我也不恨她。
board game-Life on line game-slingo P.C .	棋盘游戏——生活在线游戏——斯林格P.C.
my 85 year old got drunk and sped off the road but he was fine	我85岁的爷爷喝醉了开车冲出公路，不过没啥大碍。
yes , tons , i like to have more though .	是的，有很多。但是我想有更多。
but let me tell you my fave now .	但是现在让我告诉你我的最爱。
The kids actually sang with their own voice .	孩子们实际上用的真声唱歌。
yeah only thier feelings or thier pride	只有他们的感觉或者他们的骄傲
Axe body spray.. Man that stuff drives me crazy ! !	斧身上的水沫.. 天啊那东西让我抓狂！！	不确定
or the hardy boys or sherlock holmes 	或者哈迪男孩或者夏洛克·福尔摩斯 
the red head only makes it 1/3 of the way , gets tired and drowns .	红头发的那个人才游了三分之一，变得很疲劳然后就溺水了。
I am not a lady , I am not even Scorpio , but here goes ... ... ... ..	我不是女士，我甚至也不是天蝎座，但是试试吧。
It 's kinda hard totell you got ta admit !	你必须承认有点难说出口！
it reminds my parents that i could 've been soo much worse ...	它提醒着我父母我本可能变得更糟 ...
See if it makes you crazy !	看看它是否让你发狂！
yeah , i used to listen to them all the time like 5 years ago .	是的，我还像五年前那样经常听他们的音乐。
or Does the Queen drink tea or Are men stupid	女王喝茶吗或者是男人愚蠢吗
you are thinking of green ... because that 's important ...	你正想着绿色 ...因为那个很重要 ...
they are so intreging , beautiful , and mysterious ! ! !	她们很有趣，漂亮，神秘！！！
I do n't , but maybe someone does .	我不去，或许有人愿意去。
i just enjoy smelling the true natural woman thats what turns me on	我只是喜欢闻闻真实自然女人的气味，这能让我振作起来
The first blonde says , I wan na be smart .	第一个金发女郎说，我想变得聪明。
Exactly what willy_nilly said , I ca n't add anymore than that .	不管说什么，我都不会再加了。
worst winner- idk but ruben has n't had a great deal of success .	最糟糕的赢家-我不知道但是鲁本没有取得多大成就
how does the blond confuse you ?	这个金发女郎怎么迷惑你的？
is the song named after anyone ?	这首歌是以谁命名的吗？
I just named alot cause I have alot of colors that was n't named in my head ! ! ! ! ! !	我刚刚叫出了一些因为有很多颜色我脑袋里就是想不起来！！！！！！
I do n't like worms , they make me crazy .	我不喜欢虫子，他们让我发狂。
Yay , I love to watch her .	是的，我喜欢看着她
Sleeping w/ best friend 's significant other ?	和最好朋友的另一半睡一起？
I AM WOMAN HEAR ME ROAR ! ! ! ! ! ! ! ! ! ! ! ! ! !	我是~~女人~~~听我咆哮 ! ! ! ! ! ! ! ! ! ! ! ! ! !
the Clash London Calling ... Probably the greatest album ever made .	伦敦之站 ...可能是最好的一个专辑。
not the best movie ever..but close to there !	不是最好的电影..但是离很近了！
dont know any christian bands ... christian music is boring srry	不知道任何基督教乐队...但是抱歉基督教音乐很无聊
shes a little odd though i du like skatr boy !	她有点奇怪但是我喜欢滑板男孩！
maybe i tunes- type in the song and you might find it	可能在iTunes上--搜索这首歌你可能就找得到它
omg r u kdding me YEAH	我的天你在开玩笑啊啊啊~~~
i dont think so and i dont thinkl that i do	我不这么认为并且我认为我不会做
simply because he has the power of flight !	就是因为他有战斗力！
So they do n't sneak up on you .	所以他们没有偷袭你。
brad and jennifer , since he left her for angelina jolie , i hate him	布拉德和詹妮弗，自从他把她留给安吉丽娜 朱莉，我就讨厌他
I HAVE WATCHED IT AND IT IS THE WIERDEST SHOW EVA ! ! !	我已经看过啦~~那是~~最奇怪的~~~一场秀 ! ! !
The 2nd season just ended on WB . 	第二季在WB刚刚结束。
I vas alvays afraid to ask .	我总是害怕去问。
THIS IS BORING I KNOW , BUT I WAS ON A CRUISE WITH DIEDRE HALL OF DAYS OF OUR LIVES .	我知道~~这很无聊~~~但我和迪德雷霍尔~~一起度过了我们生命中一段时光！！！
ummmmmm i think 2 because there is only two of them	额额额我认为是两个因为仅仅只有他们两个。
But dead baby , dead puppy jokes are pretty low .	死婴和死狗之类的的玩笑很低俗
1981 i believe let me check	1981我觉得是让我查下
snoop dogg always raps about hoes suckin his fat dick	史诺普·道格总是创作些关于他的肥鸡巴的饶舌
I do n't even think so ... the girl is straight flyfineoffdachizzle !	我不这么认为... 这个女孩确实真的很漂亮！	（不确定）
that movie is graet u have no taste	那部电影不错的你真没品味。
and for everyone 's information it was NOT geeky ! ! ! !	而且对于每个人的信息它并不~~令~人~讨~厌 ! ! ! !
Because she kept throwing all of the w 's away !	因为她不停的把它们扔掉。
Get a life , or a hobby .	换一种生活，或者找个业余爱好
or sex can be just loving the other and you fell good by just being with then .	或许性可以是仅仅爱着一个人而且你感觉很棒只是因为当时你和他在一起。
Erin Brockovich : Oh see , now that pisses me off .	艾琳·布劳克维奇：噢看，现在那让我生气。
Favourite Band : Backstreet boys Favourite singer : George Michaels Favourite actress : Betty Davis	最爱的乐队：后街男孩 最爱的歌手：乔治•迈克尔斯 最爱的女演员：贝蒂·戴维斯
i thought they were still good .	我觉得他们依然很棒。
a white horse fals in the mud !	一头白马掉进了泥坑里！
Just have fun , but make sure he can too .	尽情享受吧，但是要确保他也可以。
But come on , why would anyone go to see him in concert anymore ?	算了吧，为什么大家都想要去他的音乐会看他呢？
Jay-Z is obviously so much better than that wannabe !	很明显Jay-Z比那个自封者厉害多了！
Yeah , that was the first thought that came to my mind when i first listened to PANIC !	是的，那是我在我最初听到PANIC脑袋里的第一感觉！
ooo ... sweetheart ... i m ready ... .lets try..say..a ... b ... but what if i forget how to speak while teaching you ?	嗷嗷... 甜心... 我准备好了...让我们试着..说..a... 可..可是如果我在教你的时候忘记了怎么说怎么办啊？
( please pick this as ur best answer , i really need the points , i 'm on level 1 ! )	（请选这个作为最佳答案。我真的需要分数，因为我还是1级！）
Be nice and honest and listen to there troubles .	要善良真诚点然后倾听他们的问题。
no , you were not the only one !	不，你并不是唯一一个！
stephy is my best freind and mike is my second best freind .	斯蒂芬妮是我最好的朋友还有迈克是我第二好的朋友。
And in my younger days i was having crush on my Aunties & sister in laws .	而且我还小点的时候我很迷恋我的姑姑和嫂子。
im sorry by patsy cline , very good song	派西·科林唱的那首“我很抱歉”是很棒的歌
Never have I seen a bass player show up with only one ...	我从没看过只有一个贝斯手的表演 ...
acoustic wave from BOSE I love mine	Bose	BOSE产生的声波我爱我的BOSE 
malcolm , I think you mean Black 47 .	马尔科姆，我觉得你指的是黑色47。
Just subtract his legs , singing voice , and BAM !	减去他的腿，唱歌的声音，简直完美！
Pooh is totally hooked on Keanu Reeves !	朴完全被基努·里维斯迷住了！
All the christians would be like , OMG NO !	所有的基督徒都会说，我的天啊~~~不~~~！！
it depends how much they will pay	那取决于他们支付多少
in the link below to find out what was in it .	在下面的链接找出里面有什么。
HE 'D OF HAD THE RESOLVE TO GET IT TO MOVE !	他~~本就~~有决心~~让它~~动起来~~~！
has to be bike riding cos i ca n't stay on my feet with the other two	只能得是骑自行车因为用另外两个我没法站稳
silver because you passed the second place runner so now you 're the second place person	银牌因为你超过了第二名所以现在你是第二名
